111111
100111
101011
1S0101
11E001
111111
