1111111
1000001
1000001
10U0001
1000001
1000001
1111111
