111111111
1P0000001
100C000E
111111111
