1111111
100E001
1P010C1
1111111
