111111111111111111111111111111
11EC000100C000P1000C0000000001
111101010111110111110111111101
110C01000100C10C00C001000C0101
11C1111111C1011111111101111101
1101C00100010C0001CC0001000101
11C101010111111101010111010101
11010100000000010C010000010001
111111111111111111111111111111
