1111111111
1000000001
1PCE000001
1000000001
1111111111
